15 15
F - - - - 7 0 0 0 0 0 0 0 0 0
| > 7 v 0 | 0 0 0 0 0 0 0 0 0
| v | L 7 | 0 0 0 0 0 0 0 0 0
L J L - + J 0 0 0 0 0 0 0 0 0
F T T - { 0 0 0 0 0 0 0 0 0 0
| L J F A - - - - - < 0 0 0 0
^ 0 0 } 7 0 0 0 0 0 0 0 0 0 0
0 0 0 | L - - - < 0 0 0 0 0 0
0 0 0 | 0 0 0 0 0 0 0 0 0 0 0
0 0 0 ^ 0 0 0 0 0 0 0 0 0 0 0
0 0 0 0 0 0 0 0 0 0 0 0 0 0 0
0 0 0 0 0 0 0 0 0 0 0 0 0 0 0
0 0 0 0 0 0 0 0 0 0 0 0 0 0 0
0 0 0 0 0 0 0 0 0 0 0 0 0 0 0
0 0 0 0 0 0 0 0 0 0 0 0 0 0 0
(0,14)
(8,5)